....................
......#.#...........
.....##.############
######..############
#####...############
#####...############
#####...############
#.......############
#....###############
#...################
#..#################
....................
#...############..##
##.#########.......#
##.########.....####
##.########...######
##.########..#######
##...............###
####################
####################
