.......#######################################################....#
.............#################################################....#
###..#####...#################################################....#
###..#.............................#.........................##...#
###..#....#####################....#............###########..#....#
###..#........................#....#........................##..#.#
###..#........................#....#.........#...............#....#
###..#..#.....................#....#.........#...............##...#
###..#........................#....#.........#.........#######....#
###..#........................#..............#...............#...##
###..#........................#..........#...#...............#....#
###..#.....##############.....#....############################...#
###..#.....................#..#....#.........................#....#
###..#.....................#..#....#.........................#...##
###..#.....................#..#....#.........######..........#....#
###..#.....................#..#...##.........................#.#..#
###..#....................##..#....#.........................#....#
###..#.........##...##.....#..#....#.........................#...##
###..#.........##...##.....#..#....#.....#............#......#....#
###..#.........##.#.##.#...#..##...#.....#............#......##...#
###..#.........##...##.....#..#..........#............#......#....#
###..#....##...##...##.....#..#..........#............#......#...##
###..#..#.##################..#....#########################.#....#
###..#..#..#...............#..#...##.........................##...#
###..#..##.#...............#..#....#.........................#....#
###..#..#..#...............#..#....#.........................#...##
###..#..#.##...............#..#....#.........................#....#
###..#..#.......##...##....#..##...#.........................##...#
###..#..#####..............#..#....#.........................#....#
###..#..#####..............#..#....#.........................#...##
###..#..#####..............#..#....#.........................#....#
###..#..#####.............##..#...##.........................#....#
###..#..#................###..#....#.........................##...#
###..#..#..#################..#....#.........................#....#
###..#..#..................#..#....#.........................#....#
###..#..###................#..##...#.........................#....#
###..#.....................#..#....#.........................#...##
###..#.....................#..#....#..............................#
###..#..#################..#..#....#.......#..........#...........#
###..#..#.................##..#...##.........................#....#
###..#..#................###..#....#.........................#....#
###..####...............####..#....#.........................#....#
###....................#####..#....###########################....#
###################################################################

