............##################################################....#
............##################################################....#
###..##.....##################################################....#
###..#.............................#.........................##...#
###..#....#####################....#............###########..#....#
###..#........................#....#........................##..#.#
###..#........................#....#.........#...............#....#
####.#..#.....................#....#.........#...............##...#
###..#........................#....#.........#.........#######....#
###..#........................#..............#...............#...##
###..#........................#..........#...#...............#....#
###..#.....##############.....#....############################...#
###..#.....................#..#....#.........................#....#
###.##.....................#..#....#.........................#...##
###..#.....................#..#....#.........######..........#....#
###..#.....................#..#...##.........................#.#..#
###..#....................##..#....#.........................#....#
###..#.........##...##.....#..#....#.........................#...##
###..#.........##...##.....#..#....#.....#............#......#....#
###..#.........###..###....#..##...#.....#............#......##...#
####.#.........##...##.....#..#..........#............#......#....#
###..#..#.##...##...##.....#..#..........#............#......#...##
###..#..#.##################..#....#########################.#....#
###..#..#..#...............#..#...##.......................#.##...#
###..#..##.#...............#..#....#.........................#....#
###..#..#..#...............#..#....#..########################...##
###..#..#.##...............#..#....#..########################....#
###.##..#.......##...##....#..##...#..#########################...#
###..#..#####..............#..#....#..########################....#
###..#..#####..............#..#....#..########################...##
###..#..#####..............#..#....#..########################....#
###..#..#####.............##..#...##..########################....#
####.#..#................###..#....#..#########################...#
###..#..#..#################..#....#.........................#....#
###..#..#..................#..#....##........................#....#
###..#..###................#..##...#.........................#....#
###..#.....................#..#....#...#.....................#...##
###..#.....................#..#....#..............................#
###.##..#################..#..#....#.......#..........#...........#
###..#..#.................##..#...##.........................#....#
###..#..#................###..#....#.........................#....#
###..####...............####..#....#.........................#....#
###....................#####.......###########################....#
###################################################################

