#....#########################################################....#
#....#########################################################....#
#....#########################################################....#
###..#.............................#.........................##...#
###..#....#####################....#............###########..#....#
###..#........................#....#........................##..#.#
###..#........................#....#.........#...............#....#
####.#..#.....................#....#.........#...............##...#
###..#........................#....#.........#.........#######....#
###..#........................#..............#...............#...##
###..#........................#..........#...#...............#....#
###..#.....##############.....#....############################...#
###..#.....................#..#....#.........................#....#
###.##.....................#..#....#.........................#...##
###..#.....................#..#....#.........######..........#....#
###..#.....................#.##...##.........................#.#..#
###..#....................##..#....#.........................#....#
###..#.........##...##.....#..#....#.........................#...##
###..#.........##...##.....#..#....#.....#............#......#....#
###..#.........###..###....##.##...#.....#............#......##...#
####.#.........##...##.....#..#..........#............#......#....#
###..#..#.##...##...##.....#..#..........#............#......#...##
###..#..#.##################..#....#########################.#....#
###..#..#..#...............#.##...##########################.##...#
###..#..##.#...............#..#....#.........................#....#
###..#..#..#...............#..#....#..########################...##
###..#..#.##...............#..#....#..########################....#
###.##..#.......##...##....##.##...#..#########################...#
###..#..#####..............#..#....#..########################....#
###..#..#####..............#..#....#..########################...##
###..#..#####..............#..#....#..########################....#
###..#..#####.............##.##...##..########################....#
####.#..#................###..#....#..#########################...#
###..#..#..#################..#....#.........................#....#
###..#..#..................##.#....##........................#....#
###..#..###................#..##...#.........................#....#
###..#.....................#..#....#.........................#...##
###..#.....................#.##....#..............................#
###.##..#################..#..#....#.......#..........#...........#
###..#..#.................##..#...##.........................#....#
###..#..#................####.#....#.........................#....#
###..####...............####..#....#.........................#....#
###....................#####..#....###########################....#
###################################################################

